R 600 600
NO ./textures/arena.xpm
SO	./textures/space.xpm
WE	./textures/flames.xpm
EA  ./textures/wood2.xpm
S   ./textures/barrel.xpm
F 156,215,10
C 100,100,255

111111111
122202221
122202221
122202221
122202221
122202221
122202221
122202221
122202221
122202221
122202221
122202221
122202221
122202221
122202221
122202221
122202221
122202221
122202221
122202221
122202221
122202221
122202221
122202221
122202221
122202221
122202221
122202221
122202221
122202221
122202221
122202221
122202221
122202221
122202221
122202221
122202221
122202221
122202221
122202221
122202221
122202221
122202221
122202221
122202221
122202221
122202221
122202221
122202221
122202221
122202221
122202221
122202221
122202221
122202221
122202221
122202221
122202221
122202221
122202221
122202221
122202221
122202221
122202221
122202221
122202221
122202221
122202221
122202221
122202221
122202221
122202221
122202221
122202221
122202221
122202221
122202221
122202221
122202221
122202221
122202221
122202221
122202221
122202221
122202221
122202221
122202221
122202221
122202221
122202221
122202221
122202221
122202221
122202221
122202221
122202221
122202221
122202221
122202221
122202221
122202221
122202221
122202221
122202221
122202221
122202221
122202221
122202221
122202221
122202221
122202221
122202221
122202221
122202221
122202221
122202221
122202221
122202221
122202221
122202221
122202221
122202221
122202221
122202221
122202221
122202221
122202221
122202221
122202221
122202221
122202221
122202221
122202221
122202221
122202221
122202221
122202221
122202221
122202221
122202221
122202221
122202221
122202221
122202221
122202221
122202221
122202221
122202221
122202221
122202221
122202221
122202221
122202221
122202221
122202221
122202221
122202221
122202221
122202221
122202221
122202221
122202221
122202221
122202221
122202221
122202221
122202221
122202221
122202221
122202221
122202221
122202221
122202221
122202221
122202221
122202221
122202221
122202221
122202221
122202221
122202221
122202221
122202221
122202221
122202221
122202221
122202221
122202221
122202221
122202221
122202221
122202221
122202221
122202221
122202221
122202221
122202221
122202221
122202221
122202221
122202221
122202221
122202221
122202221
122202221
122202221
122202221
122202221
122202221
122202221
122202221
122202221
122202221
122202221
122202221
122202221
122202221
122202221
122202221
122202221
122202221
122202221
122202221
122202221
122202221
122202221
122202221
122202221
122202221
122202221
122202221
122202221
122202221
122202221
122202221
122202221
122202221
122202221
122202221
122202221
122202221
122202221
122202221
122202221
122202221
122202221
122202221
122202221
122202221
122202221
122202221
122202221
122202221
122202221
122202221
122202221
122202221
122202221
122202221
122202221
122202221
122202221
122202221
122202221
122202221
122202221
122202221
122202221
122202221
122202221
122202221
122202221
122202221
122202221
122202221
122202221
122202221
122202221
122202221
122202221
122202221
122202221
122202221
122202221
122202221
122202221
122202221
122202221
122202221
122202221
122202221
122202221
122202221
122202221
122202221
122202221
122202221
122202221
122202221
122202221
122202221
122202221
122202221
122202221
122202221
122202221
122202221
122202221
122202221
122202221
122202221
122202221
122202221
122202221
122202221
122202221
122202221
122202221
122202221
122202221
122202221
122202221
122202221
122202221
122202221
122202221
122202221
122202221
122202221
122202221
122202221
122202221
122202221
122202221
122202221
122202221
122202221
122202221
122202221
122202221
122202221
122202221
122202221
122202221
122202221
122202221
122202221
122202221
122202221
122202221
122202221
122202221
122202221
122202221
122202221
122202221
122202221
122202221
122202221
122202221
122202221
122202221
122202221
122202221
122202221
122202221
122202221
122202221
122202221
122202221
122202221
122202221
122202221
122202221
122202221
122202221
122202221
122202221
122202221
122202221
122202221
122202221
122202221
122202221
122202221
122202221
122202221
122202221
122202221
122202221
122202221
122202221
122202221
122202221
122202221
122202221
122202221
122202221
122202221
122202221
122202221
122202221
122202221
122202221
122202221
122202221
122202221
122202221
122202221
122202221
122202221
122202221
122202221
122202221
122202221
122202221
122202221
122202221
122202221
122202221
122202221
122202221
122202221
122202221
122202221
122202221
122202221
122202221
122202221
122202221
122202221
122202221
122202221
122202221
122202221
122202221
122202221
122202221
122202221
122202221
122202221
122202221
122202221
122202221
122202221
122202221
122202221
122202221
122202221
122202221
122202221
122202221
122202221
122202221
122202221
122202221
122202221
122202221
122202221
122202221
122202221
122202221
122202221
122202221
122202221
122202221
122202221
122202221
122202221
122202221
122202221
122202221
122202221
122202221
122202221
122202221
122202221
122202221
122202221
122202221
122202221
122202221
122202221
122202221
122202221
122202221
122202221
122202221
122202221
122202221
122202221
122202221
122202221
122202221
122202221
122202221
1000S0001
122202221
122202221
122202221
122202221
122202221
122202221
122202221
122202221
122202221
122202221
122202221
122202221
122202221
122202221
122202221
122202221
122202221
122202221
122202221
122202221
122202221
122202221
122202221
122202221
122202221
122202221
122202221
122202221
122202221
122202221
122202221
122202221
122202221
122202221
122202221
122202221
122202221
122202221
122202221
122202221
122202221
122202221
122202221
122202221
122202221
122202221
122202221
122202221
122202221
122202221
122202221
122202221
122202221
122202221
122202221
122202221
122202221
122202221
122202221
122202221
122202221
122202221
122202221
122202221
122202221
122202221
122202221
122202221
122202221
122202221
122202221
122202221
122202221
122202221
122202221
122202221
122202221
122202221
122202221
122202221
122202221
122202221
122202221
122202221
122202221
122202221
122202221
122202221
122202221
122202221
122202221
122202221
122202221
122202221
122202221
122202221
122202221
122202221
122202221
122202221
122202221
122202221
122202221
122202221
122202221
122202221
122202221
122202221
122202221
122202221
122202221
122202221
122202221
122202221
122202221
122202221
122202221
122202221
122202221
122202221
122202221
122202221
122202221
122202221
122202221
122202221
122202221
122202221
122202221
122202221
122202221
122202221
122202221
122202221
122202221
122202221
122202221
122202221
122202221
122202221
122202221
122202221
122202221
122202221
122202221
122202221
122202221
122202221
122202221
122202221
122202221
122202221
122202221
122202221
122202221
122202221
122202221
122202221
122202221
122202221
122202221
122202221
122202221
122202221
122202221
122202221
122202221
122202221
122202221
122202221
122202221
122202221
122202221
122202221
122202221
122202221
122202221
122202221
122202221
122202221
122202221
122202221
122202221
122202221
122202221
122202221
122202221
122202221
122202221
122202221
122202221
122202221
122202221
122202221
122202221
122202221
122202221
122202221
122202221
122202221
122202221
122202221
122202221
122202221
122202221
122202221
122202221
122202221
122202221
122202221
122202221
122202221
122202221
122202221
122202221
122202221
122202221
122202221
122202221
122202221
122202221
122202221
122202221
122202221
122202221
122202221
122202221
122202221
122202221
122202221
122202221
122202221
122202221
122202221
122202221
122202221
122202221
122202221
122202221
122202221
122202221
122202221
122202221
122202221
122202221
122202221
122202221
122202221
122202221
122202221
122202221
122202221
122202221
122202221
122202221
122202221
122202221
122202221
122202221
122202221
122202221
122202221
122202221
122202221
122202221
122202221
122202221
122202221
122202221
122202221
122202221
122202221
122202221
122202221
122202221
122202221
122202221
122202221
122202221
122202221
122202221
122202221
122202221
122202221
122202221
122202221
122202221
122202221
122202221
122202221
122202221
122202221
122202221
122202221
122202221
122202221
122202221
122202221
122202221
122202221
122202221
122202221
122202221
122202221
122202221
122202221
122202221
122202221
122202221
122202221
122202221
122202221
122202221
122202221
122202221
122202221
122202221
122202221
122202221
122202221
122202221
122202221
122202221
122202221
122202221
122202221
122202221
122202221
122202221
122202221
122202221
122202221
122202221
122202221
122202221
122202221
122202221
122202221
122202221
122202221
122202221
122202221
122202221
122202221
122202221
122202221
122202221
122202221
122202221
122202221
122202221
122202221
122202221
122202221
122202221
122202221
122202221
122202221
122202221
122202221
122202221
122202221
122202221
122202221
122202221
122202221
122202221
122202221
122202221
122202221
122202221
122202221
122202221
122202221
122202221
122202221
122202221
122202221
122202221
122202221
122202221
122202221
122202221
122202221
122202221
122202221
122202221
122202221
122202221
122202221
122202221
122202221
122202221
122202221
122202221
122202221
122202221
122202221
122202221
122202221
122202221
122202221
122202221
122202221
122202221
122202221
122202221
122202221
122202221
122202221
122202221
122202221
122202221
122202221
122202221
122202221
122202221
122202221
122202221
122202221
122202221
122202221
122202221
122202221
122202221
122202221
122202221
122202221
122202221
122202221
122202221
122202221
122202221
122202221
122202221
122202221
122202221
122202221
122202221
122202221
122202221
122202221
122202221
122202221
122202221
122202221
122202221
122202221
122202221
122202221
122202221
122202221
122202221
122202221
122202221
122202221
122202221
122202221
122202221
122202221
122202221
122202221
122202221
122202221
122202221
122202221
122202221
122202221
122202221
122202221
122202221
122202221
122202221
122202221
122202221
122202221
122202221
122202221
122202221
122202221
122202221
122202221
122202221
122202221
111111111
